11111111111111111111
1P0100000000000010C1
10010000011111101011
10010111000000001001
100101C0000000001101
10010110111111100001
10000010000000Z00001
11111010100111111101
10000010100000000001
10011110101011111101
10000000101010000001
10101111101010111111
10100000001010101E11
10100000001010101011
10101111100010001011
1C000000000010000011
11111111111111111111