111111
100C01
10C001
10ECC1
10C001
10P001
111111