111111111111111
1P0100010000E01
100100000000001
10100001000Z001
100100010000001
100001110000001
1000001C0110001
111111100011001
100000001000001
111111111111111