11111111111111111111
10000000100000111001
10000000010000000001
10000000000000000001
1C000000010000000001
10000000010000000001
11111110010C00111101
100000000100P0000001
10000000010000000001
1111111000000000E001
10000000010000000Z01
11111111111111111111