1111111111111111111111111111111111111111
1P00000000000000000000000000000000C00001
1011111111111111110111111111111111111101
1011111111111111110111111111111111111101
1011111111111111110111111111111111111101
1000000000000000000000000000000000000001
1011111111111111110111111111111111111101
1011111111111111110111111111111111111101
1011111111111111110111111111111111111101
1011111111111111110111111111111111111101
1010000000000000000000000000000000000011
1011111111111111110111111111111111111101
1011111111111111110111111111111111111101
1011111111111111110111111111111111111101
1011111111111111110111111111111111111101
1000000C0000000000E0000000000000000C0001
1011111111111111110111111111111111111101
1011111111111111110111111111111111111101
1011111111111111110111111111111111111101
1011111111111111110111111111111111111101
10000000000000000000000000000000Z0000001
1011111111111111110111111111111111111101
1011111111111111110111111111111111111101
1011111111111111110111111111111111111101
1000000000000000000000000000000000000001
1011111111111111110111111111111111111101
1011111111111111110111111111111111111101
1011111111111111110111111111111111111101
10000000000000000000000000000000000C0001
1111111111111111111111111111111111111111